8 7
5 1
1 1 1 1 1 1 1 1
1 1 1 0 0 0 1 1
1 0 0 2 3 0 1 1
1 0 0 3 2 3 0 1
1 1 1 0 4 2 0 1
1 1 1 0 0 0 1 1
1 1 1 1 1 1 1 1
